#############################################################
#___________________________________________________________#
#___________________________________________________________#
#__________#________________________________________________#
#__________#________________________#####___________________#
#__________#________________________________________________#
#__________#________________________________________________#
#__________#________________________________________________#
#__________#________________________________________________#
#__________#________________________________________________#
#__________#________________________________________________#
#__________#________________________________________________#
#__________#________________________________________________#
#__________#________________________________________________#
#__________#________________________________________________#
#__________#________________________________________________#
#__________#________________________________________________#
#__________#________________________________________________#
#__________#________________________________________________#
#__________#________________________________________________#
#__________#________________________________________________#
#__________#________________________________________________#
#__________#________________________________________________#
#__________#________________________________________________#
#__________#________________________________________________#
#__________#________________________________________________#
#__________#________________________________________________#
#__________#________________________________________________#
#__________#________________________________________________#
#__________#________________________________________________#
#__________#________________________________________________#
#__________#________________________________________________#
#__________#________________________________________________#
#__________#________________________________________________#
#__________#________________________________________________#
#__________#________________________________________________#
#__________#_______________________________#________________#
#__________#_______________________________#________________#
#__________#_______________________________#________________#
#__________#_______________________________#________________#
#__________#_____________________________#__________________#
#__________#_____________________________#__________________#
#__________#______________________________#_________________#
#############################################################