#############################################################
#___________________________________________________________#
#___________________________________________________________#
#__________#________________________________________________#
#__________#_________0______________#####___________________#
#__________#________________________________________________#
#__________#________________________________________________#
#__________#________________________________________________#
#__________#______________________0_________________________#
#__________#________________________________________________#
#__________#________________________________________________#
#__________#__________________________________00000000______#
#__________#________________________________________________#
#__________#________________________________________________#
#__________#________________________________________________#
#__________#________________________________________________#
#__________#________________________________________________#
#__________#________0000____________________________________#
#__________#________________________________________________#
#__________#________________________________________________#
#__________#________________________________________________#
#_____0____#________________________________________________#
#__________#__________00____________________________________#
#__________#________________________________________________#
#__________#________________________________________________#
#__________#________________________________________________#
#__________#________________________________________________#
#__________#________________________________________________#
#__________#________________________________________________#
#__________#________________________________________________#
#__________#________________________________________________#
#__________#________________________________________________#
#__________#________________________________________________#
#__________#________________________________________________#
#__________#_______________________________#________________#
#__________#_______________________________#________________#
#__________#______________0________________#________________#
#__________#_______________________________#_________0______#
#__________#_____________________________#__________________#
#__________#_____________________________#__________________#
#__________#______________________________#_________________#
#############################################################