#############################################################
#___________________________________________________________#
#___________________________________________________________#
#___________________________________________________________#
#___________________________________________________________#
#___________________________________________________________#
#___________________________________________________________#
#___________________________________________________________#
#___________________________________________________________#
#___________________________________________________________#
#___________________________________________________________#
#___________________________________________________________#
#___________________________________________________________#
#___________________________________________________________#
#__________#________________________________________________#
#__________#________________________________________________#
#__________#________________________________________________#
#___________________________________________________________#
#__________#________________________________________________#
#__________#________________________________________________#
#__________#___________________0____________________________#
#___________________________________________________________#
#___________________________________________________________#
#__________#________________________________________________#
#__________#________________________________________________#
#__________#________________________________________________#
#__________#________________________________________________#
#__________#________________________________________________#
#__________#________________________________________________#
#__________#________________________________________________#
#__________#________________________________________________#
#__________#________________________________________________#
#__________#________________________________________________#
#__________#________________________________________________#
#__________#________________________________________________#
#__________#________________________________________________#
#___________________________________________________________#
#___________________________________________________________#
#__________#________________________________________________#
#__________#________________________________________________#
#__________#________________________________________________#
#############################################################